{
  "LocalizationStrings": {
    "1": "生命",
    "2": "物攻",
    "3": "魔攻",
    "4": "物防",
    "5": "魔防",
    "6": "速度",
    "7": "生命",
    "8": "物攻",
    "9": "魔攻",
    "10": "物防",
    "11": "魔防",
    "12": "速度",
    "13": "生命",
    "14": "物攻",
    "15": "魔攻",
    "16": "物防",
    "17": "魔防",
    "18": "速度",
    "19": "生命",
    "20": "物攻",
    "21": "魔攻",
    "22": "物防",
    "23": "魔防",
    "24": "速度",
    "25": "生命",
    "26": "物攻",
    "27": "魔攻",
    "28": "物防",
    "29": "魔防",
    "30": "速度",
    "31": "生命",
    "32": "物攻",
    "33": "魔攻",
    "34": "物防",
    "35": "魔防",
    "36": "速度",
    "37": "生命",
    "38": "物攻",
    "39": "魔攻",
    "40": "物防",
    "41": "魔防",
    "42": "速度",
    "43": "生命",
    "44": "物攻",
    "45": "魔攻",
    "46": "物防",
    "47": "魔防",
    "48": "速度",
    "49": "生命",
    "50": "物攻",
    "51": "魔攻",
    "52": "物防",
    "53": "魔防",
    "54": "速度",
    "55": "生命",
    "56": "物攻",
    "57": "魔攻",
    "58": "物防",
    "59": "魔防",
    "60": "速度",
    "61": "生命",
    "62": "物攻",
    "63": "魔攻",
    "64": "物防",
    "65": "魔防",
    "66": "速度",
    "67": "生命",
    "68": "物攻",
    "69": "魔攻",
    "70": "物防",
    "71": "魔防",
    "72": "速度",
    "73": "生命",
    "74": "物攻",
    "75": "魔攻",
    "76": "物防",
    "77": "魔防",
    "78": "速度",
    "79": "生命",
    "80": "物攻",
    "81": "魔攻",
    "82": "物防",
    "83": "魔防",
    "84": "速度",
    "85": "生命",
    "86": "物攻",
    "87": "魔攻",
    "88": "物防",
    "89": "魔防",
    "90": "速度",
    "91": "生命",
    "92": "物攻",
    "93": "魔攻",
    "94": "物防",
    "95": "魔防",
    "96": "速度",
    "97": "生命",
    "98": "物攻",
    "99": "魔攻",
    "100": "物防",
    "101": "魔防",
    "102": "速度",
    "103": "生命",
    "104": "物攻",
    "105": "魔攻",
    "106": "物防",
    "107": "魔防",
    "108": "速度",
    "109": "生命",
    "110": "物攻",
    "111": "魔攻",
    "112": "物防",
    "113": "魔防",
    "114": "速度",
    "115": "生命",
    "116": "物攻",
    "117": "魔攻",
    "118": "物防",
    "119": "魔防",
    "120": "速度",
    "121": "生命",
    "122": "物攻",
    "123": "魔攻",
    "124": "物防",
    "125": "魔防",
    "126": "速度",
    "127": "生命",
    "128": "物攻",
    "129": "魔攻",
    "130": "物防",
    "131": "魔防",
    "132": "速度",
    "133": "生命",
    "134": "物攻",
    "135": "魔攻",
    "136": "物防",
    "137": "魔防",
    "138": "速度",
    "139": "生命",
    "140": "物攻",
    "141": "魔攻",
    "142": "物防",
    "143": "魔防",
    "144": "速度",
    "145": "生命",
    "146": "物攻",
    "147": "魔攻",
    "148": "物防",
    "149": "魔防",
    "150": "速度",
    "151": "生命",
    "152": "物攻",
    "153": "魔攻",
    "154": "物防",
    "155": "魔防",
    "156": "速度",
    "157": "生命",
    "158": "物攻",
    "159": "魔攻",
    "160": "物防",
    "161": "魔防",
    "162": "速度",
    "163": "生命",
    "164": "物攻",
    "165": "魔攻",
    "166": "物防",
    "167": "魔防",
    "168": "速度",
    "169": "生命",
    "170": "物攻",
    "171": "魔攻",
    "172": "物防",
    "173": "魔防",
    "174": "速度",
    "175": "生命",
    "176": "物攻",
    "177": "魔攻",
    "178": "物防",
    "179": "魔防",
    "180": "速度",
    "181": "生命",
    "182": "物攻",
    "183": "魔攻",
    "184": "物防",
    "185": "魔防",
    "186": "速度",
    "187": "生命",
    "188": "物攻",
    "189": "魔攻",
    "190": "物防",
    "191": "魔防",
    "192": "速度",
    "193": "生命",
    "194": "物攻",
    "195": "魔攻",
    "196": "物防",
    "197": "魔防",
    "198": "速度",
    "199": "生命",
    "200": "物攻",
    "201": "魔攻",
    "202": "物防",
    "203": "魔防",
    "204": "速度",
    "205": "生命",
    "206": "物攻",
    "207": "魔攻",
    "208": "物防",
    "209": "魔防",
    "210": "速度",
    "211": "生命",
    "212": "物攻",
    "213": "魔攻",
    "214": "物防",
    "215": "魔防",
    "216": "速度",
    "217": "生命",
    "218": "物攻",
    "219": "魔攻",
    "220": "物防",
    "221": "魔防",
    "222": "速度",
    "223": "生命",
    "224": "物攻",
    "225": "魔攻",
    "226": "物防",
    "227": "魔防",
    "228": "速度",
    "229": "生命",
    "230": "物攻",
    "231": "魔攻",
    "232": "物防",
    "233": "魔防",
    "234": "速度",
    "235": "生命",
    "236": "物攻",
    "237": "魔攻",
    "238": "物防",
    "239": "魔防",
    "240": "速度",
    "241": "生命",
    "242": "物攻",
    "243": "魔攻",
    "244": "物防",
    "245": "魔防",
    "246": "速度",
    "247": "生命",
    "248": "物攻",
    "249": "魔攻",
    "250": "物防",
    "251": "魔防",
    "252": "速度",
    "253": "生命",
    "254": "物攻",
    "255": "魔攻",
    "256": "物防",
    "257": "魔防",
    "258": "速度",
    "259": "生命",
    "260": "物攻",
    "261": "魔攻",
    "262": "物防",
    "263": "魔防",
    "264": "速度",
    "265": "生命",
    "266": "物攻",
    "267": "魔攻",
    "268": "物防",
    "269": "魔防",
    "270": "速度",
    "271": "生命",
    "272": "物攻",
    "273": "魔攻",
    "274": "物防",
    "275": "魔防",
    "276": "速度",
    "277": "生命",
    "278": "物攻",
    "279": "魔攻",
    "280": "物防",
    "281": "魔防",
    "282": "速度",
    "283": "生命",
    "284": "物攻",
    "285": "魔攻",
    "286": "物防",
    "287": "魔防",
    "288": "速度",
    "289": "生命",
    "290": "物攻",
    "291": "魔攻",
    "292": "物防",
    "293": "魔防",
    "294": "速度",
    "295": "生命",
    "296": "物攻",
    "297": "魔攻",
    "298": "物防",
    "299": "魔防",
    "300": "速度"
  }
}